8 8
G G G G G G G G 
G G G G G G G G 
G G G G G G G G 
G G G P P P P P 
G G G P G G G G 
G G G P G G G G 
S P P P G G G G 
G G G G G G G G 